111111111111111111111111111
10P000010000000000000000001
100000010000000000000000001
100000010000000010000000001
100000000000000010000000001
100000000000000010000000001
111111111111111111111111111
