11111111111111111111
1C0100EC00000001N0C1
1N000111110000N10001
1P001110000C00000001
11111111111111111111
