1111111111111
10P00000P0001
1000C00000001
1000000000001
10000000000E1
1111111111111
